{"BLOCK_MAP":
    [
    "666666666666",
    "444557755444",
    "333333333333",
    "222222222222",
    "111111111111",
    "            ",
    "            ",
    "            ",
    "            "
    ]
}
