{"BLOCK_MAP":
    [
    "666666666666",
    "444557755444",
    "335337733533",
    "332224442233",
    "  11111111  ",
    "            ",
    "            ",
    "            ",
    "            "
    ]
}